R  2000  1000
NO   ./textures_hi/metal.xpm
SO  ./textures_hi/brick.xpm
WE      ./textures_hi/stone.xpm
EA  ./textures_hi/wood.xpm
S    ./textures_hi/eye.xpm
F 128,223,255
C 0,153,51

111111111111111111111111111111111111111111
122222222222222222222222222222222223200001
122222222222222222222222222222222221111101
1222222222222222222222222222222222222222W1
122222222222222222222222222222222222222221
122222222222222222222222222222222222222221
122222222222222222222222222222222222222221
122222222222222222222222222222222222222221
122222222222222222222222222222222222222221
122222222222222222222222222222222222222221
122222222222222222222222222222222222222221
122222222222222222222222222222222222222221
122222222222222222222222222222222222222221
122222222222222222222222222222222222222221
122222222222222222222222222222222222222221
111111111111111111111111111111111111111111