R  3000    1500
NO   ./textures_hi/metal.xpm
SO  ./textures_hi/brick.xpm
WE      ./textures_hi/stone.xpm
EA  ./textures_hi/wood.xpm
S    ./textures_hi/metal.xpm
F 128,223,255
C 0,153,51

111111111111111111111111111111111111111111
122222222222222222222222222222222222222221
122222222222222222222222222222222222222221
122222222222222222222222222222222222222221
122222222222222222222222222222222222222221
122222222222222222222222222222222222222221
122222222222222222222222222222222222222221
122222222222222222222222222222222222222221
122222222222222222222222222222222222222221
122222222222222222222222222222222222222221
122222222222222222222222222222222222222221
122222222222222222222222222222222222222221
122222222222222222222222222222222222222221
122222222222222222222222222222222222222221
10000000000000000000N000000000000000000001
111111111111111111111111111111111111111111