R   1500    1000     
NO    ./textures_hi/stone.xpm
SO    ./textures_hi/brick.xpm
WE      ./textures_hi/wood.xpm
EA  ./textures_hi/metal.xpm
S    ./textures_hi/eye.xpm
F  50,50,50
C 236,186,92

11111111111111111111
12200010000000300041
12000010060000111111
15000104000000200001
12000010000004000221
10050000000010000001
10000000012000000001
10050000110005000W01
10000000000000000001
11111111111111111111