R   1000    500     
NO    ./textures_hi/metal.xpm
SO    ./textures_hi/brick.xpm
WE      ./textures_hi/metal.xpm
EA  ./textures_hi/wood.xpm
S    ./textures_hi/eye.xpm
F  255,223,255
C 0,153,51

111111111111111111111111111111111111111111
12222222222222222222222  2222222222223 200001
1222222522222222222222222222222 22221111101
1222222522222222222222222222222222222222W1
122222252222222222222222222222222222222221
122222252222222222222222222222222222222221
1222222522222222222222 22222222222222222221
122222252222222222222222222222222222222221
122222252222222222222222222222222222222221
122222252222222222222222222222222222222221
122222252222222222222222222222222222222221
122222252222222222222222222222222222222221
100000050000000000000000000055500000000001
100000050000000000000004000055500000000001
100000050000000000000000000055500000000001
111111111111111111111111111111111111111111
