R  3000    1500
NO   ./textures_hi/metal.xpm
SO  ./textures_hi/brick.xpm
WE      ./textures_hi/stone.xpm
EA  ./textures_hi/wood.xpm
S    ./textures_hi/eye.xpm
F 128,223,255
C 0,153,51

111111111111111111111111111111111111111111
100000000000000000002000000000000000000001
100000000000000000000000000000000000000001
100000000000000000000000000000000000000001
100000000000000000000000000000000000000001
100000000000000000000000000000000000000001
100000000000000000000000000000000000000001
100000000000000000000000000000000000000001
100000000000000000000000000000000000000001
100000000000000000000000000000000000000001
100000000000000200010100000000000000000001
100000000000000000100010000000000000000001
100000000000000000102010000000000000000001
10000000000000000010N010000000000000000001
100000000000000000111110000000000000000001
111111111111111111111111111111111111111111