R   1000    500     
NO    ./textures_hi/metal.xpm
SO    ./textures_hi/brick.xpm
WE      ./textures_hi/metal.xpm
EA  ./textures_hi/wood.xpm
S    ./textures_hi/eye.xpm
F  255,223,255
C 0,153,51

11111111111111111111
12200000000000340001
12000000000000111131
150000000000002000W1
12000000000000025221
10000000000000000001
10000000000000000001
10000000000000000001
10000000000000000001
10000000000000000001
10000000000000000001
10000000000000000001
10000000000000000001
10000000000000000001
10000000000000000001
10000000000000000001
11111111111111111111