R   1000    500     
NO    ./textures_hi/metal.xpm
SO    ./textures_hi/brick.xpm
WE      ./textures_hi/metal.xpm
EA  ./textures_hi/wood.xpm
S    ./textures_hi/eye.xpm
F  255,223,255
C 0,153,51

111111111
122340001
120111131
1502000W1
120025221
111111111