R   1000    500     
NO    ./textures_hi/metal.xpm
SO    ./textures_hi/brick.xpm
WE      ./textures_hi/metal.xpm
EA  ./textures_hi/wood.xpm
S    ./textures_hi/eye.xpm
F  255,223,255
C 0,153,51

1111111111111111
1220000000340001
1200000000111131
15000000002000W1
1200000000025221
1000000000000001
1000000000000001
1000000000000001
1000000000000001
1000000000000001
1111111111111111