R  3000    1500
NO   ./textures_hi/metal.xpm
SO  ./textures_hi/brick.xpm
WE      ./textures_hi/stone.xpm
EA  ./textures_hi/wood.xpm
S    ./textures_hi/metal.xpm
F 128,223,255
C 0,153,51

11111
10001
10201
10N01
11111