R   1000    500     
NO    ./textures_hi/kirby_wall.xpm
SO    ./textures_hi/falcon.xpm
WE      ./textures_hi/tag.xpm
EA  ./textures_hi/mario.xpm
S    ./textures_hi/kirby.xpm
F  119,128,123
C 48,169,243

11111111111111111111
12200000000000300061
12000000000000111111
150000000000002000W1
12000010000000025221
10000101000000000001
10000010000000500001
10000050000000000001
10000000000000000001
10000000000005000001
10000000500000000001
10050000000100000001
10000000011100000001
10000000010000000001
10050000110005000001
10000400000000000001
11111111111111111111