R 960 740
NO ./path_to_the_north_texture
SO ./path_to_the_south_texture
WE ./path_to_the_west_texture
EA ./path_to_the_east_texture

S ./path_to_the_sprite_texture
F 128,223,255
C 0,153,51

11111111111111 
1E001000110001
11000010000101
10011000110101
11111111111111