R  960    740
NO   ./textures/barrel_wood.xpm
SO  ./textures/brick.xpm
WE      ./textures/stone.xpm
EA  ./textures/wood.xpm
S    ./textures/wood.xpm
F 128,223,255
C 0,153,51

111111111111111111111111111111111111111111
1N0010001100010001000100000000000000000001
110000100001010100010100101000110111000101
100110001101010101110101000010001000101011
110001010000110010100010011001000100010001
101010001010010100100000000100101011100001
101010110011010010011010000101000001001001
101010000101000110000100011000100000010001
100010100010010000100000100010100001000001
111101011011111111111111111111111111111111
100000000000000000000000000000000000000001
110000000010001000000000000000000000000001
100000000111011100000000000000011111000001
110000000010001000000000000000000000000001
100000000000000000000000000000000000000001
111111111111111111111111111111111111111111