         0123456789                 -> x y ^
123456789          0123456789
                             
11111111111111111111111111111	- 1
10110000001100000000000000001	- 2
1N110000011100000020000010001	- 3
10010000000000000000000010001	- 4
10110000011100000000000010001	- 5
10000000001100000111011110001	- 6
11110111111111011100000010001	- 7
11110111111111011101010010001	- 8
11000000110101011100000010001	- 9
10002000000000001100000011011	- 10
10000000000000001101010010001	- 11
11000000110101011111011110001	- 12
11110111111101011111011110001	- 13
11111111111111111111111111111	- 14