R 960 740
NO ./path_to_the_north_texture
SO ./path_to_the_south_texture
WE ./path_to_the_west_texture
EA ./path_to_the_east_texture

S ./path_to_the_sprite_texture
F 128,223,255
C 0,153,51

1 1 1 1 1 1 1 1 1 1 1
1 0 0 0 0 0 0 0 0 0 1
1 0 1 1 0 0 0 1 1 0 1
1 0 1 0 0 0 0 0 1 0 1
1 0 0 0 0 N 0 0 0 0 1
1 0 1 0 0 0 0 0 1 0 1
1 0 1 1 0 0 0 1 1 0 1
1 0 0 0 0 0 0 0 0 0 1
1 1 1 1 1 1 1 1 1 1 1