R 1960 1120
NO ./path_to_the_north_texture
SO ./path_to_the_south_texture
WE ./path_to_the_west_texture
EA ./path_to_the_east_texture

S ./path_to_the_sprite_texture
F 128,223,255
C 0,153,51

1111111111111111111111111111
1011111111111111111111111101
1001111111111111111111111001
1000111111111111111111111001
1000011111111111111111110001
1000001111111111111111100001
1000000111111111111111000001
1000000011111111111110000001
1000000001111111111100000001
1000000000111111111000000001
1000000000011111110000000001
1000000000001111100000000001
1000000000000111000000000001
1000000000000010000000000001
1000000000000000000000000001
1000000000000000000000000001
1000000000000000000000000001
1000000000000000000000000001
1000000000000000000000000001
1000000000000000000000000001
1000000000000000000000000001
10000000000000N0000000000001
1111111111111111111111111111