R   1000    500     
NO    ./textures_hi/mario.xpm
SO    ./textures_hi/mario.xpm
WE      ./textures_hi/mario.xpm
EA  ./textures_hi/mario.xpm
S    ./textures_hi/toad.xpm
F  238,245,93
C 34,218,240

1111111111111111111
1S10103030303030301
1313030301010303031
1030301030303030301
1113030303030303031
1510103010301030301
1313030103010103031
1030303030101010301
1111010101030303031
1035103010303030301
1311030103030303031
1610303010301030301
1313030103030303031
1010303030303010301
1313030301030141011
1230303010351030301
1111111111111111111