R   1000    500     
NO    ./textures_hi/mario.xpm
SO    ./textures_hi/mario.xpm
WE      ./textures_hi/mario.xpm
EA  ./textures_hi/mario.xpm
S    ./textures_hi/toad.xpm
F  238,245,93
C 34,218,240

1111111111111111111111111
1E00100010001000100010001
1050001030103010001030501
1000100010001000100010001
1131113111111131113111011
1000100010001000100010001
1010301000101010301010101
1000100010001000100010001
1131113111011101111111111
1000100010001000100010001
1010001030103010101030101
1000100010001000100010001
1111111111111131113111111
1000100010001000122210001
1050301000100010125210501
1000100010001000122210001
1111111111111111111111111