R   1000    500     
NO    ./textures_hi/mario.xpm
SO    ./textures_hi/mario.xpm
WE      ./textures_hi/mario.xpm
EA  ./textures_hi/mario.xpm
S    ./textures_hi/toad.xpm
F  238,245,93
C 34,218,240

1111111111111111111
1S10103035303030361
1313035301010301031
1030301030301030301
1113030303030301011
1510103010301030151
1313030153010151531
1030303010101010151
1111010101030301631
1632103010303030151
1311030103010313031
1514103010301030301
1313010103030303031
1010303010303010301
1311010301030141011
1630303010351030301
1111111111111111111